###########///|
# M           |
#             |
#    E ###    |
#      ###    |
#       M     |
#  @     E    |
              |
#      ###    |
#    M ###    |
#             |
#   E         |
# M           |
###########///.